R 1000 600
NO ./text/wood.xpm
WE ./text/colorstone.xpm
SO ./text/greystone.xpm
S  ./text/barrel.xpm
EA ./text/mossy.xpm
C 135,206,235
F 222,184,135
        1111111111111111111111111
        1000000000110000000002001
        1011000001110000000002001
        1001000000000000000000001
11111111101100000111000000000W001
100000000011000001110111111111111
11110111111111011100000010001
11110111111111011101010010001
11000000110101011100000010001
10000000000000001100000000001
10000000000000001101010010001
1100000111010101111101111000111
11110111 1110101 101111010001
11111111 1111111 111111111111
